x......x
........
...xx...
..xxxx..
...xx...
........
x......x
