x..............x
................
................
................
................
................
.....x....x.....
....xx.zz.xx....
x....x..z.x....x
xx.....zzz....xx
xxx..........xxx
xxxx........xxxx
................
..ssssssssssss..
..ssssssssssss..
..ssssssssssss..
..ssssssssssss..
x......xx......x
